{
    "map":
    [
        [6, 6, 6, 6, 6, 6, 6, 6, 6],
        [0, 0, 0, 0, 5, 0, 0, 0, 6],
        [6, 0, 1, 3, 3, 3, 1, 0, 6],
        [6, 5, 3, 0, 0, 0, 1, 5, 6],
        [6, 5, 3, 0, 0, 0, 2, 0, 5],
        [6, 0, 1, 2, 1, 3, 1, 0, 6],
        [6, 0, 0, 0, 5, 5, 0, 0, 6],
        [6, 6, 6, 6, 6, 6, 6, 0, 6]
    ],
    "mapping":["floor", "wall", "door", "window", "softWall", "entrance", "barrier"]
}
